B W W B B W B W W 
B L L V L L L L B 
W L L L L D L L B 
B L L D L L L L W 
B L D L L L L L W 
W L L L L L V L B 
W V L L L L L L W 
W L L L D L L L W 
B B W B W B B W W